##################################################
#.....##.#..#....#.#.........#.....##.##.....#.#.#
##.##.....#..##.#....#.#.#.#...##.#......###...#.#
#...#.#.#...#.....#.#..#.#.#.##.##..#.#.##..#.#..#
##.##.#.#.#...#.##.#.#.##..#.....#.#.#.....#.#.#.#
#..#...##.#.#.#....#..#...#..###......#.#.#..#.#.#
##.##.##..#.#..#.##..#.#.#.#.#..#.#.##.#.###.....#
#...#...#.#..##....#...##...#..#.#.#......#..#####
##.#..#.#..#..##.###.##.#.#..#.......###.#.#.....#
#..#.#...#..##...........##.##.###.##..#...#.##.##
##..#.#.#..#...#.##.#.##..........#.#.#.##.....#.#
#..#...#.#.##.#..#..###..#####.#.#......#.###.#..#
#.#.#.##....##..#.#....#......#.#.#.#.#......#.#.#
#.....#.#.#...##....##.#.##.##.......#..##.##....#
#.##.#.....#.#...#.##.#....#...#.#.#..#.#....##.##
#..#.#.###..###.#..#..#.##...#..#..#.#.#..##.....#
#.#...#....#.###.#...#....#.#..#.#.#....#..#.#.#.#
#..#.###.#....##..#.#..#.##..#.#..##.#.#.##..#.#.#
#.##..#...#.#....#...#.#...#.#...#...#.#.##.#..#.#
#.#..#.#.#...####..##...#.#..#.#.##.##.....##.#..#
#..##....#.#....##..#.#.#.#.#.#...#.#..###...#.#.#
#.#..#.#.#.#.###...#.#...#.#...#.#.###.#.#.#.#.#.#
#..#.#..#...##...#...#.#.....#.#....#.....#.#....#
##....#.#.#...#.#..#..##.##.#.#.#.##..#.##...#.#.#
##.#.#.#..#.##.###..#...#.#......#.##.#...#.##.#.#
#...#....#.....##..#..#...#.#.#.#...#.#.##..#..#.#
##.#.#.#..#.###...#..#.##..#.##..#.#..#....#..##.#
#....#..#.#...#.#..#.....#.....#....#.#.#.##.#...#
#.#.#..#..#.#.##.##..#.#..#.#.#..##.#..#....#..#.#
#.#.#.###.#.#......#..#..#.#.#.#.###..#..##.##.#.#
##..##.##.#.#.#.#.##.#.#.......##.#.#.###.#...#..#
#.#......#.#...#..#.....##.###......#.....#.##.#.#
#...##.#.#...####.#.##.#......#.#.##..#.###.....##
##.##..#..#.#..##..#..#..#.##..#..##.#.....##.#..#
#....#..#.#..#....#.#...#...#.#.#...#.##.##.##.#.#
#.#.###..#..#.#.#....##.#.#.#....#.##...#.......##
#.#..#.#.##.#.#.#.##...#..##..###.##.##...##.##..#
#..#.#....#....##.#.#.#.##..#...........#.#..#..##
#.##..##.###.#...##........#..##.#.#.##..####..#.#
#...##....#...##.#..#.##.##..#.#.####..####..#...#
#.##...#.#..#...#.#..#...#..#......#..#..#..##.###
#..##.##..#..#.#...#..#.#..#.#.#.#...#.#...#.....#
#.#..#...#..#...#.#.###..#...##..#.#.....##.##.#.#
#...#..#..#..##........#..#.#...#..#.#.#......####
#.##.#.#.#..#..#.#.####.#..#..#.###..#..#.#.##.#.#
#.....#...#.#.##.#.......##..#.....#.#.##.#..#...#
#.##.###.#.#......#.#.###...#.#.#.#.#....#.#...#.#
#...#.#..#..#.#.##..#....#.#..#.#....#.#....###.##
#.#....#..#...#...##..##..###...#.#.#..#.##......#
##################################################